702 700 707 700 700 700 700 704 704 704 705 28 28 28 28 28 704 28 705 705 705 705 703 703 703 
702 702 707 700 700 700 704 704 704 704 705 704 701 11 701 704 28 704 709 709 19 705 703 703 703 
700 702 707 700 700 700 704 704 704 704 705 701 706 701 704 28 704 709 709 705 705 705 703 703 703 
700 702 707 700 700 704 704 704 704 705 11 706 706 704 28 704 709 709 701 704 704 705 703 703 703 
700 702 707 707 6 704 704 704 705 701 701 706 706 704 28 704 709 706 706 701 704 705 703 703 703 
700 702 700 707 704 704 704 704 705 701 11 706 706 701 7 4 6 4 7 704 28 704 28 703 703 
700 702 700 707 704 704 704 705 701 9 706 706 706 706 3 9 9 9 3 704 28 701 703 703 703 
700 702 700 707 704 704 704 705 701 707 707 707 707 707 6 9 9 9 3 28 699 701 703 703 703 
700 702 700 707 707 707 704 705 701 707 706 706 706 706 3 9 9 9 3 704 701 701 703 703 703 
700 702 700 707 704 707 707 707 705 707 706 706 706 706 7 4 6 4 7 701 701 701 703 703 703 
700 702 702 707 704 704 705 707 707 707 708 708 706 706 706 706 708 706 706 701 701 701 703 703 703 
700 700 702 707 704 704 704 705 701 701 706 708 708 706 11 706 708 706 706 701 701 703 703 703 703 
700 707 5 707 700 704 704 704 705 701 701 706 708 708 706 706 708 18 706 701 703 703 703 703 703 
700 707 702 700 700 704 704 704 704 705 701 701 706 708 708 708 708 708 708 701 703 703 703 703 703 
700 707 702 702 700 700 704 702 704 704 705 701 701 706 706 701 706 706 708 701 703 703 703 703 703 
700 707 700 702 702 702 702 702 704 704 705 704 704 701 701 701 701 704 6 703 703 703 703 703 703 
700 707 700 700 700 700 700 704 704 704 705 28 28 28 28 28 28 28 703 703 703 703 703 703 703 
